XX....XX......................XX...XX...............
............XXXXXXXXX.X..........................XXX
......XX....XXX....XXXX..........................XXX
XXXX........XXX......XXXXXX................XXXXXXXXX
XXX................XXXXXX..............XXXXXXXXXXX..
X...........................XX......................
........XXXX..............XXX.......................
XXXXXXXXXXXXXXX.................................XXXX
XXXXXXX.........................XXX............XXXXX
